#############################
#................#..........#
#..1......s......#..........#
#..................s........#
#..2.....................e..#
#...............s...........#
#..3.......#................#
#..........#................#
#####################...#####
                    #####

jason lu plays eroge everyday

characters: 3
control: [1, 2]
symtable:
  '#': wall
  '.': floor
  's': switch