#############################
#...........................#
#..1.............#..........#
#...........................#
#..2.....................e..#
#...........................#
#..3.......#................#
#...........................#
#####################...#####
                    #####

jason lu plays eroge everyday

symtable:
  '#': wall
  '.': floor