#############################
#................#..........#
#..1.............#..........#
#...........................#
#..2.....................e..#
#...........................#
#..3.......#................#
#..........#................#
#####################...#####
                    #####

jason lu plays eroge everyday

characters: [1, 2, 3]
control: [1, 2]
symtable:
  '#': wall
  '.': floor