#############################
#..........##...............#
#..........##...............#
#..........##...............#
#...........e...............#
#...1...s..##...........2...#
#..........##...............#
#..........##...............#
#############################                    

jason lu plays eroge everyday

characters: 2
control: [1]
symtable:
  '#': wall
  '.': floor
  "e": exit
  "s": switch