#############################
#.1..#..2...................#
#....#......................#
#....#......................#
#....#......................#
#..##################.......#
#...........................#
#...........e...............#
#############################                    

jason lu plays eroge everyday

characters: 2
control: [1]
symtable:
  '#': wall
  '.': floor
  "e": exit