#############################
#%%%%%####2%%%%%%%%%%%%%%%%%#
##1%#%.#.#.................##
#%%%%%%%%#..................#
#####%.#.#..................#
#....%####..................#
#..#es#.....................#
#..####.....................#
#...........................#                
#############################
jason lu plays eroge everyday

characters: 2
control: [1]
symtable:
  '#': wall
  '.': floor
  "e": exit
  "%": ice
  "s": switch