################################# 
#...p....##.2......#...........p#
#...1....##........#............#
#...e....##........#........s...#
#........##........#............#
#........##........#............#
#...p....##.......p#............#
#################################                

jason lu plays eroge everyday

characters: 2
control: [1]
symtable:
  '#': wall
  '.': floor
  "e": exit
  "s": switch
  "p": portal
portals:
  - 4,1,31,1,-1
  - 4,6,18,6,1

