#############################
#..1.....s.##..........3...p#
#..........##...............#
#..........##...#############
#..e.......##...............#
#..........##...........2...#
#..........##...............#
#...p......##...............#
#############################                    

jason lu plays eroge everyday

characters: 3
control: [1]
symtable:
  '#': wall
  '.': floor
  "e": exit
  "s": switch
  "p": portal
portals:
  - (27,1),(4,7),1
  - (4,7),(27,1),1
  