#############################
#p.1.......##..........3...p#
#..........##...............#
#..........##...#############
#..e.......##...............#
#..........##...........2...#
#..........##...............#
#.........s##...............#
#############################                    

jason lu plays eroge everyday

characters: 3
control: [1]
symtable:
  '#': wall
  '.': floor
  "e": exit
  "s": switch
  "p": portal
portals:
  - 27,1,1,1,1
